Jan.	January
Feb.	February
Mar.	March
Apr.	April
May
Jun.	June
Jul.	July
Aug.	August
Sep.	September
Oct.	October
Nov.	November
Dec.	December
Jan	January
Feb	February
Mar	March
Apr	April
Jun	June
Jul	July
Aug	August
Sep	September
Oct	October
Nov	November
Dec	December
